0102020000
0202030000
0202030000
0202020100
0203020101
0203020101
0203010201
0203010102
0203010102
0203000202
0203000103
0203000103
0203000103
0203000103
0302000203
0302000203
0302000203
0302000203
0302000203
0302000203
0302000203
0302000203
0302000203
0302000203
0303000204
0303000204
0303000204
0303000204
0303000204
0303000204
0303000105
0303000105
0303000105
0303000105
0303000106
0303000106
0303000007
0303000007
0303000008
0303000008
